1111111111111111111111111111111111111
101000100010C01000100010001000100PE01
1010101010101010101010101010101010001
1000100010001000100010001000100010001
1111111111111111111111111111111111111
